1111111111
10000000P1
10000E0001
10000000C1
1111111111