1111111111111
10000000000P1
10000E0000001
10000000C0001
1111111111111