1111111111
10000000P1
10000E0001
10C0000001
11111C1111