1111111111
10000000P1
10000E0001
10C00E0001
1111111111