1111111111111111111111111111111111
1E0000000000000C00000C000000000001
1010010100100100101001010010101011
1010010010101010001001000000010101
1P0000000C00C000C000000000000000C1
1010101010101010101010101010101011
1C00000000000000000000000000000011
1111111111111111111111111111111111
